LA_name,LA_code,Total_Death,total_population,toddlers,kids,teenagers,working_professionals,senior_citizens,males,females,econ_active,econ_inactive,males_econ_active,males_econ_inactive,females_econ_active,females_econ_inactive
Hartlepool,E06000001,250,92028,5698,5192,11931,53609,15598,44751,47277,43513,23291,23108,9573,20405,13718
Middlesbrough,E06000002,365,138412,9431,8276,18549,81465,20691,67732,70680,63582,36969,33801,15879,29781,21090
Redcar and Cleveland,E06000003,315,135177,7553,7098,16638,77636,26252,65655,69522,63530,35647,33180,15131,30350,20516
Stockton-on-Tees,E06000004,438,191610,12322,10973,24276,114088,29951,94082,97528,96259,44395,50595,18812,45664,25583
Darlington,E06000005,244,105564,6579,6074,12632,61840,18439,51483,54081,53443,23192,27913,9837,25530,13355
Halton,E06000006,274,125746,8354,7383,15659,75869,18481,61368,64378,63411,29297,33203,12341,30208,16956
Warrington,E06000007,514,202228,12309,11555,24803,121347,32214,100300,101928,107765,41696,56706,18041,51059,23655
Blackburn with Darwen,E06000008,416,147489,11278,10478,20540,86132,19061,73547,73942,67033,37384,37430,15076,29603,22308
Blackpool,E06000009,382,142065,8218,7436,16700,82472,27239,69775,72290,68540,35273,35962,15894,32578,19379
Kingston upon Hull,E06000010,611,256406,17358,13974,31360,157983,35731,128420,127986,128130,62480,69585,26947,58545,35533
East Riding of Yorkshire,E06000011,748,334179,16400,16630,39021,190673,71455,163388,170791,168860,76734,89224,32333,79636,44401
North East Lincolnshire,E06000012,252,159616,10005,8966,19535,92823,28287,78247,81369,79227,36596,42619,14744,36608,21852
North Lincolnshire,E06000013,278,167446,10282,9377,19705,98043,30039,82623,84823,84668,37661,45827,15233,38841,22428
York,E06000014,337,198051,10677,9348,23809,120802,33415,96254,101797,104945,44844,54200,19297,50745,25547
Derby,E06000015,707,248752,17743,14983,31585,146772,37669,123046,125706,123691,55600,66060,23172,57631,32428
Leicester,E06000016,810,329839,24297,20780,44652,202894,37216,162884,166955,156425,85807,85795,34335,70630,51472
Rutland,E06000017,65,37369,1854,1850,5247,20569,7849,18915,18454,18758,8294,10271,3622,8487,4672
Nottingham,E06000018,636,305680,19959,16429,42919,190821,35552,153777,151903,142327,89745,76978,41124,65349,48621
Herefordshire,E06000019,293,183477,9580,9180,21178,104523,39016,90302,93175,95114,38328,50822,15631,44292,22697
Telford and Wrekin,E06000020,242,166641,11344,10007,22090,99111,24089,82549,84092,84947,37332,46004,15195,38943,22137
Stoke-on-Trent,E06000021,716,249008,17092,14189,30295,148614,38818,123995,125013,119743,63065,65624,26665,54119,36400
Bath and North East Somerset,E06000022,265,176016,9238,8700,22850,103411,31817,86072,89944,89752,40798,46887,17550,42865,23248
Bristol,E06000023,565,428234,29633,22837,48744,271148,55872,213071,215163,227119,94387,121060,41272,106059,53115
North Somerset,E06000024,333,202566,11653,11024,22905,114351,42633,98463,104103,102607,42745,53941,17461,48666,25284
South Gloucestershire,E06000025,390,262767,15925,14608,33457,154368,44409,130424,132343,143198,49270,75930,20447,67268,28823
Plymouth,E06000026,207,256384,15336,12947,31449,154937,41715,126684,129700,127742,64044,67809,27958,59933,36086
Torbay,E06000027,149,130959,6690,6277,14661,72477,30854,63110,67849,61795,32205,32279,13603,29516,18602
Swindon,E06000030,317,209156,14083,12273,24857,129089,28854,104618,104538,117039,37041,63408,14346,53631,22695
Peterborough,E06000031,316,183631,13904,11424,22847,110578,24878,90859,92772,95646,36672,52078,13894,43568,22778
Luton,E06000032,509,203201,16592,14221,26772,121735,23881,101954,101247,100272,44936,56057,17148,44215,27788
Southend-on-Sea,E06000033,607,173658,11213,9498,20378,101771,30798,85037,88621,88324,36683,47619,14486,40705,22197
Thurrock,E06000034,447,157705,12005,10231,19802,95646,20021,77823,79882,84464,29660,45531,11203,38933,18457
Medway,E06000035,729,263925,17224,15967,35796,157933,37005,130825,133100,137954,56204,74758,22291,63196,33913
Bracknell Forest,E06000036,157,113205,8027,6745,14313,69973,14147,56107,57098,65137,17979,34612,6804,30525,11175
West Berkshire,E06000037,223,153822,10065,9017,19547,91567,23626,76321,77501,85401,26653,45822,10055,39579,16598
Reading,E06000038,267,155698,11937,8556,17777,99596,17832,77967,77731,86329,30479,46757,12337,39572,18142
Slough,E06000039,313,140205,12777,9994,17608,87002,12824,70120,70085,73819,26639,40732,9720,33087,16919
Windsor and Maidenhead,E06000040,313,144560,9365,8584,17206,85328,24077,71328,73232,77650,26597,41769,9997,35881,16600
Wokingham,E06000041,267,154380,10031,9551,19227,91782,23789,76464,77916,84912,27361,45346,10312,39566,17049
Milton Keynes,E06000042,501,248821,19908,16468,30525,154409,27511,123116,125705,137717,43668,73548,16490,64169,27178
Brighton and Hove,E06000043,405,273369,15015,13291,31451,177920,35692,136108,137261,150853,59939,79645,26570,71208,33369
Portsmouth,E06000044,355,205056,13548,11031,26883,126182,27412,103201,101855,105834,47871,56830,21795,49004,26076
Southampton,E06000045,342,236882,15407,11847,29497,149355,30776,119453,117429,123193,57008,66841,25392,56352,31616
Isle of Wight,E06000046,255,138265,6412,6542,16158,76199,32954,67424,70841,64218,35529,33606,15738,30612,19791
County Durham,E06000047,1349,513242,28574,25659,61136,305528,92345,251280,261962,247101,136695,129926,59705,117175,76990
Cheshire East,E06000049,909,370127,20194,19744,43462,215355,71372,181409,188718,191253,79700,101124,32969,90129,46731
Cheshire West and Chester,E06000050,863,329608,18050,17443,38842,194173,61100,160586,169022,170778,72377,89389,29902,81389,42475
Shropshire,E06000051,539,306129,15698,15632,36866,174634,63299,151606,154523,158983,64909,85814,26768,73169,38141
Cornwall,E06000052,504,532273,27366,26073,61772,301821,115241,257805,274468,259484,129374,136388,53259,123096,76115
Isles of Scilly,E06000053,0,2203,105,105,170,1317,506,1102,1101,1331,291,703,114,628,177
Wiltshire,E06000054,773,470981,28373,27199,58473,271448,85488,231754,239227,250792,88803,134856,34006,115936,54797
Bedford,E06000055,479,157479,10099,9376,20405,92731,24868,77312,80167,81782,31982,43412,12768,38370,19214
Central Bedfordshire,E06000056,581,254381,16009,14967,30815,152701,39889,126044,128337,139525,47133,74443,18600,65082,28533
Northumberland,E06000057,700,316028,16003,16345,36141,184235,63304,154124,161904,158268,74956,82645,31548,75623,43408
Cambridge,E07000008,121,123867,6703,5073,15244,82246,14601,62984,60883,62886,35397,33993,16922,28893,18475
East Cambridgeshire,E07000009,97,83818,5506,5016,9366,49623,14307,41443,42375,45920,14794,24633,5601,21287,9193
Fenland,E07000010,207,95262,5221,4841,11133,54748,19319,46811,48451,47829,21429,25863,8600,21966,12829
Huntingdonshire,E07000011,250,169508,10098,9704,20679,101727,27300,84532,84976,93481,31865,50202,12710,43279,19155
South Cambridgeshire,E07000012,182,148755,9300,9061,17840,87852,24702,73790,74965,82079,25700,43908,9839,38171,15861
Allerdale,E07000026,259,96422,4921,4706,11260,55502,20033,47371,49051,48904,22074,25890,9415,23014,12659
Barrow-in-Furness,E07000027,165,69087,3719,3641,8513,40259,12955,34185,34902,33897,17206,18130,7503,15767,9703
Carlisle,E07000028,319,107524,6064,5515,12292,63756,19897,52478,55046,57210,22321,30206,9126,27004,13195
Copeland,E07000029,170,70603,3695,3567,8072,41915,13354,35476,35127,35335,17367,19049,7801,16286,9566
Eden,E07000030,132,52564,2383,2599,5922,30131,11529,26033,26531,28413,10322,15072,4338,13341,5984
South Lakeland,E07000031,264,103658,4466,4729,11236,58106,25121,50522,53136,53396,22435,27857,9627,25539,12808
Amber Valley,E07000032,306,122309,6404,6387,14507,72232,22779,60192,62117,63280,27278,33832,11305,29448,15973
Bolsover,E07000033,222,75866,4275,4003,9117,44687,13784,37388,38478,37442,18503,20099,7903,17343,10600
Chesterfield,E07000034,207,103788,5778,5071,12518,61130,19291,50900,52888,51909,24500,27549,10411,24360,14089
Derbyshire Dales,E07000035,167,71116,3077,3644,8240,40328,15827,35071,36045,36541,15437,19566,6492,16975,8945
Erewash,E07000036,289,112081,6527,5935,13216,66407,19996,54934,57147,59044,23565,31164,9633,27880,13932
High Peak,E07000037,238,90892,4961,4891,11242,54129,15669,44774,46118,48560,18829,25645,7965,22915,10864
North East Derbyshire,E07000038,272,99023,4799,4909,11326,57071,20918,48564,50459,49919,23541,26523,9916,23396,13625
South Derbyshire,E07000039,238,94611,5724,5609,11956,56695,14627,46963,47648,50358,19092,26971,7615,23387,11477
East Devon,E07000040,181,132457,5846,6014,14394,68857,37346,63321,69136,62455,30327,32768,12257,29687,18070
Exeter,E07000041,114,117773,6747,5535,14725,72497,18269,57211,60562,60870,28674,31471,12630,29399,16044
Mid Devon,E07000042,69,77750,4498,4243,9369,43775,15865,38070,39680,40218,15629,21218,6264,19000,9365
North Devon,E07000043,55,93667,5014,4801,10861,52183,20808,45558,48109,47119,20388,25022,8202,22097,12186
South Hams,E07000044,45,83140,3677,3957,9294,46458,19754,40116,43024,41639,18978,21701,7710,19938,11268
Teignbridge,E07000045,105,124220,5984,6041,14123,69056,29016,60179,64041,61845,27626,32127,11627,29718,15999
Torridge,E07000046,44,63839,3157,3091,7124,35489,14978,31167,32672,31158,15352,16539,6293,14619,9059
West Devon,E07000047,30,53553,2556,2650,6036,29921,12390,26123,27430,26543,12398,13878,5350,12665,7048
Purbeck,E07000051,68,44973,2114,2214,4962,24736,10947,22028,22945,22400,9979,12039,4021,10361,5958
Weymouth and Portland,E07000053,68,65167,3349,3237,7443,37523,13615,32432,32735,32103,15768,17180,7145,14923,8623
Eastbourne,E07000061,316,99412,5327,4867,11631,55284,22303,47559,51853,47926,22547,25110,9149,22816,13398
Hastings,E07000062,240,90254,5570,4772,11076,53435,15401,44014,46240,44759,21277,23557,9024,21202,12253
Lewes,E07000063,266,97502,5052,5229,11130,53937,22154,47363,50139,48194,21075,25247,8638,22947,12437
Rother,E07000064,349,90588,3999,4096,10157,46573,25763,43021,47567,39859,23002,21166,9197,18693,13805
Wealden,E07000065,374,148915,7508,8100,17831,81334,34142,71807,77108,74214,31665,39404,12056,34810,19609
Basildon,E07000066,555,174497,11405,10665,21929,102610,27888,84645,89852,89570,36225,47898,13345,41672,22880
Braintree,E07000067,402,147084,9467,8729,17612,86863,24413,72137,74947,78715,28003,42155,10444,36560,17559
Brentwood,E07000068,224,73601,3926,4057,9080,42489,14049,35582,38019,38149,14810,20373,5539,17776,9271
Castle Point,E07000069,365,88011,4173,4395,10665,49777,19001,42907,45104,44080,20546,23949,7813,20131,12733
Chelmsford,E07000070,414,168310,9994,9531,20001,100766,28018,82914,85396,91339,32354,48765,12335,42574,20019
Colchester,E07000071,351,173074,10647,9403,21317,104399,27308,85343,87731,91385,37177,48645,15000,42740,22177
Epping Forest,E07000072,383,124659,7366,6831,14619,73293,22550,60440,64219,65304,25318,34651,9438,30653,15880
Harlow,E07000073,188,81944,6020,4917,9973,48729,12305,39674,42270,43847,14822,23120,5389,20727,9433
Maldon,E07000074,139,61629,3027,3261,7288,35679,12374,30458,31171,31856,13550,17369,5141,14487,8409
Rochford,E07000075,268,83287,4369,4368,10271,47600,16679,40787,42500,42804,17621,23137,6759,19667,10862
Tendring,E07000076,576,138048,6753,6502,15641,71879,37273,66071,71977,59908,37142,31841,15103,28067,22039
Uttlesford,E07000077,129,79443,4649,4932,10386,45901,13575,39203,40240,42473,14613,22919,5404,19554,9209
Cheltenham,E07000078,216,115732,6486,5689,13757,70471,19329,56512,59220,62763,23327,33349,9391,29414,13936
Cotswold,E07000079,133,82881,3929,4126,9547,46790,18489,40104,42777,43206,16869,22947,6481,20259,10388
Forest of Dean,E07000080,112,81961,4055,4119,10297,46504,16986,40272,41689,41490,18851,22222,7821,19268,11030
Gloucester,E07000081,244,121688,8239,7113,15177,73094,18065,60104,61584,65740,23202,34743,9576,30997,13626
Stroud,E07000082,173,112779,6113,6166,13676,64847,21977,55514,57265,59980,21975,32026,8758,27954,13217
Tewkesbury,E07000083,176,81943,4616,4327,9156,47335,16509,40080,41863,43454,16231,23001,6386,20453,9845
Basingstoke and Deane,E07000084,287,167799,11355,9947,19979,102367,24151,83116,84683,94800,28443,50452,10727,44348,17716
East Hampshire,E07000085,196,115608,6209,6512,14636,65948,22303,56237,59371,60953,22569,32431,8495,28522,14074
Eastleigh,E07000086,177,125199,7737,6983,14926,74722,20831,61384,63815,69033,22549,36191,8842,32842,13707
Fareham,E07000087,264,111581,5578,5798,13379,64050,22776,54634,56947,59063,22135,31078,8928,27985,13207
Gosport,E07000088,156,82622,5425,4725,10046,48320,14106,40736,41886,42981,16518,23047,6526,19934,9992
Hart,E07000089,150,91033,5663,5734,10983,53635,15018,45174,45859,49875,16212,27000,5955,22875,10257
Havant,E07000090,296,120684,6710,6392,14810,67347,25425,58607,62077,59601,26646,31579,10623,28022,16023
New Forest,E07000091,303,176462,8592,8512,19391,95825,44142,84784,91678,86776,38022,45418,15052,41358,22970
Rushmoor,E07000092,219,93807,6747,5568,11456,58592,11444,46757,47050,54145,15507,29155,5859,24990,9648
Test Valley,E07000093,221,116398,6711,6596,14198,67496,21397,56880,59518,62141,22511,32988,8734,29153,13777
Winchester,E07000094,190,116595,6580,6497,15087,66652,21779,56629,59966,60029,24466,31510,9678,28519,14788
Broxbourne,E07000095,215,93609,6175,5550,11733,54855,15296,45357,48252,49426,18173,26024,6788,23402,11385
Dacorum,E07000096,311,144847,9718,8408,17577,86261,22883,71307,73540,77800,26610,41418,10394,36382,16216
Hertsmere,E07000098,318,100031,6707,5969,12329,58698,16328,48290,51741,52435,19076,27606,6987,24829,12089
North Hertfordshire,E07000099,298,127114,8027,7401,15039,74936,21711,62380,64734,68564,22946,36702,8640,31862,14306
Three Rivers,E07000102,229,87317,5433,5249,10972,50957,14706,42371,44946,46280,16160,24503,6006,21777,10154
Watford,E07000103,237,90301,6730,5436,10600,56384,11151,44828,45473,50770,15515,27188,5992,23582,9523
Ashford,E07000105,347,117956,7771,7358,15459,67400,19968,57232,60724,61189,23063,32412,8632,28777,14431
Canterbury,E07000106,451,151145,7514,7506,21702,85978,28445,72638,78507,71322,40545,36816,17356,34506,23189
Dartford,E07000107,285,97365,6765,5979,11927,58742,13952,48061,49304,53184,17304,28315,6694,24869,10610
Dover,E07000108,339,111674,6259,5879,13662,63357,22517,54765,56909,54478,26308,29045,11088,25433,15220
Gravesham,E07000109,295,101720,6647,6275,13252,59256,16290,50139,51581,51903,21288,27982,8234,23921,13054
Maidstone,E07000110,398,155143,9553,8785,18714,91577,26514,76492,78651,82528,30703,44332,11917,38196,18786
Sevenoaks,E07000111,275,114893,6976,6933,13970,65347,21667,55743,59150,58707,23391,31493,8596,27214,14795
Folkestone and Hythe,E07000112,364,107969,5996,5575,12921,61062,22415,53135,54834,52387,25551,28216,10673,24171,14878
Swale,E07000113,401,135835,8747,7972,17490,79003,22623,67152,68683,67913,30694,36535,12596,31378,18098
Thanet,E07000114,448,134186,8093,7241,17163,73276,28413,64555,69631,61272,33180,31943,13791,29329,19389
Tonbridge and Malling,E07000115,244,120805,7447,7668,16247,69016,20427,59207,61598,63039,23396,33427,8955,29612,14441
Tunbridge Wells,E07000116,209,115049,7308,6976,14875,66815,19075,56494,58555,59986,22066,32533,8422,27453,13644
Burnley,E07000117,290,87059,5847,5167,10580,51331,14134,42794,44265,41879,21497,22473,8917,19406,12580
Chorley,E07000118,226,107155,6203,5963,12217,64810,17962,53708,53447,56645,23306,30116,10548,26529,12758
Fylde,E07000119,254,75757,3612,3577,8095,42130,18343,36781,38976,36447,18097,19148,7845,17299,10252
Hyndburn,E07000120,211,80734,5427,5002,10337,47159,12809,39977,40757,39118,19238,21041,8077,18077,11161
Lancaster,E07000121,285,138375,7232,6467,18987,80324,25365,66841,71534,67262,36034,34529,15721,32733,20313
Pendle,E07000122,260,89452,6362,5463,10844,52433,14350,44012,45440,42765,21675,23526,8509,19239,13166
Preston,E07000123,311,140202,9323,7938,18389,85306,19246,70284,69918,70509,33576,37921,14764,32588,18812
Ribble Valley,E07000124,145,57132,2881,3103,7363,32254,11531,27973,29159,29672,11613,15488,4948,14184,6665
Rossendale,E07000125,166,67982,4329,3903,8361,40848,10541,33367,34615,35186,14889,18493,6374,16693,8515
South Ribble,E07000126,225,109057,6331,5883,12832,64599,19412,53344,55713,58577,21881,30469,9134,28108,12747
West Lancashire,E07000127,261,110685,5998,5935,14409,63468,20875,53840,56845,55680,25921,29013,10674,26667,15247
Wyre,E07000128,340,107749,5046,5164,12351,58563,26625,52225,55524,51450,26213,26832,11295,24618,14918
Blaby,E07000129,208,93915,5446,5324,11462,54808,16875,46228,47687,50661,17897,26539,7478,24122,10419
Charnwood,E07000130,323,166100,9120,8279,21810,99629,27262,82913,83187,84609,40358,44931,18248,39678,22110
Harborough,E07000131,151,85382,4665,5015,10683,49428,15591,42353,43029,45791,16122,24285,6606,21506,9516
Hinckley and Bosworth,E07000132,207,105078,5778,5519,11998,62450,19333,51700,53378,56538,21178,30046,8488,26492,12690
Melton,E07000133,91,50376,2786,2685,6017,29631,9257,24718,25658,27422,9533,14641,3775,12781,5758
North West Leicestershire,E07000134,211,93468,5477,5421,11053,55285,16232,46335,47133,48999,19557,26347,7898,22652,11659
Oadby and Wigston,E07000135,161,56170,2882,2803,8376,31222,10887,27169,29001,28119,12678,14653,5243,13466,7435
Boston,E07000136,157,64637,3841,3223,7212,37619,12742,31536,33101,33031,14275,17441,5877,15590,8398
East Lindsey,E07000137,319,136401,6202,5999,14708,74053,35439,66427,69974,60716,39212,32434,16515,28282,22697
Lincoln,E07000138,164,93541,5514,4303,12254,58144,13326,45773,47768,49523,22054,25890,9323,23633,12731
North Kesteven,E07000139,195,107766,5483,5584,12890,61317,22492,52603,55163,55065,23551,29218,9368,25847,14183
South Holland,E07000140,177,88270,4488,4295,9910,49914,19663,43119,45151,44276,19644,23710,7684,20566,11960
South Kesteven,E07000141,271,133788,7432,7174,16385,77237,25560,64656,69132,70273,27046,36738,10672,33535,16374
West Lindsey,E07000142,161,89250,4391,4508,11035,50687,18629,43491,45759,44768,20763,23601,8468,21167,12295
Breckland,E07000143,295,130491,7412,6433,15043,73465,28138,64566,65925,65029,29147,35257,11843,29772,17304
Broadland,E07000144,309,124646,6053,6239,14260,70278,27816,60794,63852,64232,26073,34063,10458,30169,15615
Great Yarmouth,E07000145,207,97277,5528,4930,11825,54623,20371,47762,49515,46018,24216,24916,10000,21102,14216
King's Lynn and West Norfolk,E07000146,389,147451,7970,7261,16085,82294,33841,72053,75398,71704,34887,38755,13818,32949,21069
North Norfolk,E07000147,185,101499,4327,4150,10308,53517,29197,49203,52296,45819,26634,24582,11126,21237,15508
Norwich,E07000148,200,132512,8425,6267,14647,83828,19345,65267,67245,68772,31930,36723,13457,32049,18473
South Norfolk,E07000149,217,124012,6816,6377,14822,69474,26523,60515,63497,63158,26179,33354,10402,29804,15777
Craven,E07000163,124,55409,2528,2692,6547,31032,12610,26754,28655,28744,11312,15003,4615,13741,6697
Hambleton,E07000164,159,89140,4348,4536,10295,50720,19241,43982,45158,47068,18187,25251,7304,21817,10883
Harrogate,E07000165,284,157869,8677,8708,18821,90769,30894,77037,80832,84662,29376,44960,11449,39702,17927
Richmondshire,E07000166,82,51965,2910,2810,6478,30691,9076,27407,24558,29017,9635,17083,3795,11934,5840
Ryedale,E07000167,67,51751,2385,2473,6211,28630,12052,25413,26338,26644,10937,14154,4468,12490,6469
Scarborough,E07000168,188,108793,5317,5071,12258,60827,25320,52570,56223,52245,27148,27428,11394,24817,15754
Selby,E07000169,119,83449,4875,4559,9859,50150,14006,40947,42502,45720,16111,24076,6430,21644,9681
Ashfield,E07000170,378,119497,7413,6663,14526,70657,20238,58665,60832,59970,28067,31894,11697,28076,16370
Bassetlaw,E07000171,214,112863,6105,5826,13915,66076,20941,56024,56839,56556,26749,30320,11530,26236,15219
Broxtowe,E07000172,261,109487,6163,5301,12303,65622,20098,54118,55369,56838,24735,30249,10540,26589,14195
Gedling,E07000173,290,113543,6470,5986,13365,66706,21016,55348,58195,59493,23791,30952,9834,28541,13957
Mansfield,E07000174,295,104466,6399,5471,12388,62262,17946,51308,53158,52392,24763,27864,10484,24528,14279
Newark and Sherwood,E07000175,223,114817,6317,6267,13876,66572,21785,56556,58261,57971,26174,30979,10908,26992,15266
Rushcliffe,E07000176,203,111129,6392,6233,13231,64850,20423,54703,56426,58045,22710,30530,9583,27515,13127
Cherwell,E07000177,231,141868,9819,8296,16996,85058,21699,70126,71742,78160,25109,41456,10120,36704,14989
Oxford,E07000178,175,151906,9251,7406,20026,98583,16640,75335,76571,74923,43514,39077,20143,35846,23371
South Oxfordshire,E07000179,204,134257,8213,7843,15951,77870,24380,66005,68252,72820,24072,38763,9349,34057,14723
Vale of White Horse,E07000180,187,120988,7411,6727,14784,70305,21761,60058,60930,65710,21767,35193,8487,30517,13280
West Oxfordshire,E07000181,179,104779,6362,5759,12054,61342,19262,51447,53332,58506,17657,31041,6704,27465,10953
Mendip,E07000187,169,109279,5915,5913,14578,61595,21278,53387,55892,56462,22191,29627,9010,26835,13181
Sedgemoor,E07000188,177,114588,6321,5961,13977,64864,23465,56048,58540,57966,24937,30851,10135,27115,14802
South Somerset,E07000189,162,161243,8771,8389,19012,90246,34825,79106,82137,82390,33400,44356,13209,38034,20191
Cannock Chase,E07000192,265,97462,5871,5405,12105,58424,15657,48126,49336,51306,20968,27499,8454,23807,12514
East Staffordshire,E07000193,390,113583,7002,6556,13878,67016,19131,56385,57198,58578,24481,31756,10111,26822,14370
Lichfield,E07000194,281,100654,5285,5381,11641,58093,20254,49920,50734,51862,22895,27695,9612,24167,13283
Newcastle-under-Lyme,E07000195,350,123871,6314,6368,15506,73175,22508,61206,62665,61568,30767,32778,13423,28790,17344
South Staffordshire,E07000196,251,108131,4878,5210,12891,62647,22505,53243,54888,56418,24300,29893,10364,26525,13936
Stafford,E07000197,320,130869,7007,6583,15053,76952,25274,65554,65315,68274,29023,36612,12939,31662,16084
Staffordshire Moorlands,E07000198,268,97106,4671,4800,11009,56245,20381,47790,49316,49988,22097,26614,9352,23374,12745
Tamworth,E07000199,193,76813,5061,4542,9581,46485,11144,37694,39119,41188,15645,21841,6098,19347,9547
Babergh,E07000200,204,87740,4451,4868,10597,49068,18756,43004,44736,44347,18728,23824,7327,20523,11401
Ipswich,E07000202,319,133384,9250,7630,16188,80486,19830,66428,66956,71423,25744,38633,10047,32790,15697
Mid Suffolk,E07000203,177,96731,5266,5394,11512,55088,19471,47924,48807,50607,19466,27380,7606,23227,11860
Elmbridge,E07000207,266,130875,9358,8639,15470,75890,21518,63462,67413,67522,24505,36313,8317,31209,16188
Epsom and Ewell,E07000208,219,75102,4628,4415,9421,44063,12575,36412,38690,39844,14326,20963,5389,18881,8937
Guildford,E07000209,220,137183,8110,7525,16413,83742,21393,67923,69260,73649,28405,39689,11354,33960,17051
Mole Valley,E07000210,239,85375,4604,4732,10360,48005,17674,41749,43626,44170,16608,23627,6382,20543,10226
Reigate and Banstead,E07000211,399,137835,9153,8091,15894,81964,22733,67422,70413,74614,24559,39639,9497,34975,15062
Runnymede,E07000212,155,80510,4802,4068,9608,48564,13468,39148,41362,42816,16977,22648,6663,20168,10314
Spelthorne,E07000213,204,95598,6017,5165,10571,57165,16680,47053,48545,52767,17149,27934,6729,24833,10420
Surrey Heath,E07000214,228,86144,5129,5153,10595,50862,14405,42868,43276,47016,15549,25315,6081,21701,9468
Tandridge,E07000215,210,82998,4886,4715,10375,47667,15355,40158,42840,43692,15765,23045,6006,20647,9759
Waverley,E07000216,300,121572,7341,7335,15637,67437,23822,59326,62246,61649,23968,33073,8955,28576,15013
Woking,E07000217,186,99198,7278,6003,10898,60176,14843,49144,50054,54052,17670,29590,6370,24462,11300
North Warwickshire,E07000218,150,62014,3285,3209,7388,36747,11385,30604,31410,33151,13019,17587,5397,15564,7622
Nuneaton and Bedworth,E07000219,274,125252,7925,7019,15303,74083,20922,61441,63811,65173,26917,34709,10916,30464,16001
Rugby,E07000220,173,100075,6269,5648,12323,58501,17334,49884,50191,53457,19302,28675,7832,24782,11470
Stratford-on-Avon,E07000221,270,120485,5965,6176,13586,68178,26580,58497,61988,63253,24475,33306,9641,29947,14834
Warwick,E07000222,242,137648,7920,7128,15152,84398,23050,68650,68998,73309,29574,38975,13073,34334,16501
Adur,E07000223,87,61182,3537,3110,6713,34388,13434,29513,31669,31054,12806,16278,4990,14776,7816
Arun,E07000224,320,149518,7386,6968,15347,80489,39328,71303,78215,71573,34498,37300,13913,34273,20585
Chichester,E07000225,288,113794,5652,5630,12609,62009,27894,54401,59393,56102,24935,29397,9606,26705,15329
Crawley,E07000226,200,106597,8071,6486,12463,66109,13468,52698,53899,59495,17853,31837,6580,27658,11273
Horsham,E07000227,225,131301,7151,7251,16345,74984,25570,63806,67495,69240,25078,36511,9596,32729,15482
Mid Sussex,E07000228,319,139860,8343,8175,16980,81055,25307,68462,71398,75025,25227,39714,9797,35311,15430
Worthing,E07000229,208,104640,6346,5559,11243,59918,21574,50384,54256,53630,20708,28026,8295,25604,12413
Bromsgrove,E07000234,247,93637,4822,4920,11281,53479,19135,46300,47337,48664,19143,25332,8569,23332,10574
Malvern Hills,E07000235,130,74631,3297,3643,9266,40444,17981,36336,38295,36261,17251,19262,7010,16999,10241
Redditch,E07000236,172,84214,5629,4886,10072,51743,11884,41848,42366,46220,16303,24642,6542,21578,9761
Worcester,E07000237,175,98768,6359,5572,12020,60208,14609,48563,50205,53966,19416,28514,7941,25452,11475
Wychavon,E07000238,248,116944,5743,6021,13398,66767,25015,57445,59499,61260,24221,32568,9831,28692,14390
Wyre Forest,E07000239,249,97975,5256,4971,10950,56335,20463,48299,49676,49712,22619,26482,9425,23230,13194
St Albans,E07000240,320,140664,10296,9082,16898,82612,21776,69040,71624,74553,25310,39859,9474,34694,15836
Welwyn Hatfield,E07000241,246,110535,6775,6033,14312,66476,16939,54364,56171,57036,24478,30258,10347,26778,14131
East Hertfordshire,E07000242,230,137687,8299,8257,17734,82144,21253,67690,69997,75434,24659,40228,9303,35206,15356
Stevenage,E07000243,153,83957,5906,4971,10691,50517,11872,41483,42474,46140,14848,24574,5669,21566,9179
Bolton,E08000001,680,276786,18765,16878,35715,162888,42540,136660,140126,134933,65790,72275,27336,62658,38454
Bury,E08000002,519,185060,12235,11108,22906,109271,29540,90588,94472,94680,40007,49527,16694,45153,23313
Manchester,E08000003,913,503127,36413,28617,65087,325466,47544,252623,250504,243224,139708,131648,62412,111576,77296
Oldham,E08000004,628,224897,16491,15422,30393,129638,32953,110155,114742,106398,53367,57835,20947,48563,32420
Rochdale,E08000005,600,211699,14754,13148,28350,124631,30816,103642,108057,101003,51739,53954,21257,47049,30482
Salford,E08000006,619,233933,16255,13011,28072,143389,33206,116782,117151,118130,54987,62941,24726,55189,30261
Stockport,E08000007,654,283275,17342,15808,33634,165464,51027,138400,144875,146296,59014,76559,24563,69737,34451
Tameside,E08000008,641,219324,14439,12455,27016,131213,34201,107650,111674,111016,50443,58731,21186,52285,29257
Trafford,E08000009,471,226578,14870,14032,27602,133801,36273,110959,115619,118064,44742,62217,18120,55847,26622
Wigan,E08000010,907,317849,19681,18044,37840,190635,51649,157996,159853,162781,73714,87048,31483,75733,42231
Knowsley,E08000011,395,145893,9121,8312,19323,86123,23014,69329,76564,69617,36538,35112,15268,34505,21270
Liverpool,E08000012,1280,466415,26099,22254,58887,293709,65466,230483,235932,226270,130606,118531,59838,107739,70768
St. Helens,E08000013,503,175308,10269,9271,21171,103197,31400,86138,89170,86121,43463,45263,18873,40858,24590
Sefton,E08000014,781,273790,14601,13768,32314,156096,57011,131237,142553,133012,65185,68496,27601,64516,37584
Wirral,E08000015,896,319783,18514,17677,38868,183758,60966,153847,165936,153240,77611,79105,32781,74135,44830
Barnsley,E08000016,717,231221,13957,12562,27768,136924,40010,113634,117587,113306,57099,60174,24496,53132,32603
Doncaster,E08000017,799,302402,19220,17072,36344,178625,51141,149230,153172,147770,73107,79454,31021,68316,42086
Rotherham,E08000018,745,257280,15738,14645,31881,150174,44842,126247,131033,125899,62060,67294,25925,58605,36135
Sheffield,E08000019,1204,552698,33977,30337,72502,330184,85698,272661,280037,270239,140765,143190,61405,127049,79360
Newcastle upon Tyne,E08000021,493,280177,16522,14035,36884,174017,38719,140226,139951,133848,79016,71558,36424,62290,42592
North Tyneside,E08000022,431,200801,11732,10653,22380,120741,35295,96883,103918,104242,43647,53906,17920,50336,25727
South Tyneside,E08000023,448,148127,8182,7551,17726,87815,26853,71560,76567,72645,36336,38256,15068,34389,21268
Sunderland,E08000024,775,275506,15378,14133,33142,166060,46793,133953,141553,135467,70085,70773,29751,64694,40334
Birmingham,E08000025,2716,1073045,81901,74360,153937,624634,138213,527806,545239,488221,272031,265992,108667,222229,163364
Coventry,E08000026,594,316960,22476,18402,42073,187759,46250,157621,159339,153745,78126,82379,34518,71366,43608
Dudley,E08000027,723,312925,18867,17934,38402,179525,58197,153819,159106,155530,71196,83647,29119,71883,42077
Sandwell,E08000028,963,308063,22669,20194,39553,178806,46841,151592,156471,146653,72855,79587,29283,67066,43572
Solihull,E08000029,550,206674,11555,11711,26517,117295,39596,100352,106322,105108,43252,55089,17477,50019,25775
Walsall,E08000030,880,269323,18373,16971,34933,153231,45815,132319,137004,126805,65169,69220,25814,57585,39355
Wolverhampton,E08000031,735,249470,16687,14442,31823,145889,40629,123441,126029,120402,59581,65252,24725,55150,34856
Bradford,E08000032,1162,522452,41167,37482,71636,302775,69392,257132,265320,243727,122490,135004,46618,108723,75872
Calderdale,E08000033,318,203826,12906,11982,25192,121274,32472,99627,104199,104893,43873,55794,18013,49099,25860
Kirklees,E08000034,869,422458,28331,26027,53724,250226,64150,208657,213801,209514,97680,114430,39220,95084,58460
Leeds,E08000035,1535,751485,47844,40581,93002,460460,109598,367935,383550,389929,170920,204788,71854,185141,99066
Wakefield,E08000036,802,325837,19545,17643,38793,194714,55142,159913,165924,164768,76229,87505,32060,77263,44169
Gateshead,E08000037,446,200214,11869,10310,23050,119740,35245,97974,102240,100184,47895,52413,20667,47771,27228
City of London,E09000001,11,7375,236,182,366,5556,1035,4091,3284,4972,1335,3012,584,1960,751
Barking and Dagenham,E09000002,513,185911,18676,14331,25342,108241,19321,90237,95674,86404,41164,46390,15359,40014,25805
Barnet,E09000003,867,356386,26239,22352,41873,218490,47432,172676,183710,184483,73960,97368,27614,87115,46346
Bexley,E09000004,579,231997,15182,14015,30846,134742,37212,111676,120321,118864,47050,61944,18190,56920,28860
Brent,E09000005,792,311215,22446,18648,36531,200914,32676,156468,154747,163991,69735,89774,28059,74217,41676
Bromley,E09000006,673,309392,20095,18061,36524,182675,52037,148588,160804,161282,61257,83986,23316,77296,37941
Camden,E09000007,308,220338,13168,10898,22117,150178,23977,107885,112453,118397,55436,62686,22670,55711,32766
Croydon,E09000008,913,363378,27972,23096,46696,221239,44375,176224,187154,190308,72740,99206,28224,91102,44516
Ealing,E09000009,741,338449,25426,20385,37716,218695,36227,169175,169274,180615,72149,98765,28207,81850,43942
Enfield,E09000010,743,312466,24513,20930,40816,187374,38833,150654,161812,153334,70690,80732,26527,72602,44163
Greenwich,E09000011,480,254557,20945,16325,31045,160126,26116,126224,128333,132073,54649,70425,22532,61648,32117
Hackney,E09000012,477,246270,19149,15360,27288,167078,17395,122029,124241,133883,53540,70453,22360,63430,31180
Hammersmith and Fulham,E09000013,281,182493,11900,8559,15537,130084,16413,88914,93579,107754,37798,55562,15485,52192,22313
Haringey,E09000014,474,254926,18112,15775,29487,169183,22369,126224,128702,138189,54873,73275,22284,64914,32589
Harrow,E09000015,645,239056,15916,14421,29694,145358,33667,118023,121033,123307,51444,66777,19677,56530,31767
Havering,E09000016,844,237232,13661,13230,29723,138341,42277,114209,123023,121642,49486,64532,18761,57110,30725
Hillingdon,E09000017,706,273936,19704,16915,35910,166229,35178,135811,138125,141542,58384,76205,23293,65337,35091
Hounslow,E09000018,569,253957,19725,14899,28622,163852,26859,127397,126560,137867,52290,75992,19987,61875,32303
Islington,E09000019,325,206125,12289,9583,19918,146299,18036,101405,104720,117488,47661,61445,19863,56043,27798
Kensington and Chelsea,E09000020,251,158649,9189,7614,12917,109814,19115,78194,80455,87517,38563,47953,14103,39564,24460
Kingston upon Thames,E09000021,305,160060,10964,8966,18405,101367,20358,78103,81957,87348,32325,46291,12600,41057,19725
Lambeth,E09000022,521,303086,20701,16376,28812,214010,23187,150921,152165,183190,54540,96183,22662,87007,31878
Lewisham,E09000023,549,275885,22004,16665,31395,179686,26135,134957,140928,151793,54462,78480,22433,73313,32029
Merton,E09000024,430,199693,14830,11407,20883,129451,23122,98515,101178,112038,37560,59958,14063,52080,23497
Newham,E09000025,745,307984,25384,20834,39998,201175,20593,160336,147648,153761,75197,90528,30400,63233,44797
Redbridge,E09000026,816,278970,21666,18924,36516,168479,33385,138073,140897,137776,61768,75716,23403,62060,38365
Richmond upon Thames,E09000027,295,186990,14038,11107,18912,117637,25296,91149,95841,104090,33689,55137,12437,48953,21252
Southwark,E09000028,419,288283,20739,15562,30063,199590,22329,142618,145665,163859,60692,86060,25372,77799,35320
Sutton,E09000029,455,190146,12750,11095,23160,115908,27233,92443,97703,103995,34715,54464,13257,49531,21458
Tower Hamlets,E09000030,500,254096,18750,15531,27825,176420,15570,130906,123190,137233,59319,79353,22815,57880,36504
Waltham Forest,E09000031,543,258249,20839,16463,30001,165380,25566,128970,129279,135015,55963,73795,22155,61220,33808
Wandsworth,E09000032,447,306995,21670,14574,24924,218916,26911,148646,158349,189789,53744,96990,20897,92799,32847
Westminster,E09000033,358,219396,12617,9726,18662,153877,24514,111548,107848,120418,55087,67674,22156,52744,32931
North Northamptonshire,E06000061,666,316851,21046,18907,38862,187791,50245,156177,160674,168246,62546,89827,24747,78419,37799
West Northamptonshire,E06000062,796,375101,24966,22287,45668,226389,55791,185165,189936,204474,70908,108224,28589,96250,42319
Buckinghamshire,E06000060,1045,505283,31832,30939,63720,294641,84151,248346,256937,267881,95892,143808,36109,124073,59783
"Bournemouth, Christchurch and Poole",E06000058,870,378888,20868,17658,41407,222299,76656,186381,192507,193157,83453,103634,35030,89523,48423
Dorset,E06000059,404,255013,11727,12178,29666,136046,65396,123937,131076,124020,56526,65863,22793,58157,33733
East Suffolk,E07000244,502,239552,12473,12346,28060,130375,56298,116684,122868,114466,55661,61252,22714,53214,32947
West Suffolk,E07000245,180,170756,10786,9258,18855,101173,30684,85747,85009,92439,32582,50736,12844,41703,19738
Somerset West and Taunton,E07000246,213,144862,7710,7224,17050,80786,32092,69855,75007,72950,30889,38036,12696,34914,18193
